



1,PLAYER,0,-2,-2,1,1,1,0
1,PLAYER,0,-2,3,1,1,1,0
1,BALL,2,-3,15,1,1,1
1,BALL,-0.5,-3,-10,1,1,1
1,BALL,3,1,10,1,1,1
1,BALL,-1,-2,-4,1,1,1
1,BALL,2,-3,5,1,1,1
1,BALL,-2,-2,1,1,1,1
1,BOX,0,1,-20,80,20,2,0,0,0,1,1
1,BOX,0,1,20,80,20,2,0,0,0,1,1
1,BOX,0,-4,0,400,2,400,0,0,0,0.4,1
1,BOX,0,1,100,400,20,2,0,0,0,1,1
1,BOX,0,1,-100,400,20,2,0,0,0,1,1
1,BOX,100,1,0,2,20,400,0,0,0,1,1
1,BOX,-100,1,0,2,20,400,0,0,0,1,1
1,BOX,5,-3,40,1,4,240,0,0,0,1,1
1,BOX,-5,-3,40,1,4,240,0,0,0,1,1
