





















1,BOX,0,1,-20,80,20,2,0,0,0,1,1
1,BOX,0,1,20,80,20,2,0,0,0,1,1
1,BOX,0,-4,0,400,2,400,0,0,0,0.4,1
1,BOX,0,1,100,400,20,2,0,0,0,1,1
1,BOX,0,1,-100,400,20,2,0,0,0,1,1
1,BOX,100,1,0,2,20,400,0,0,0,1,1
1,BOX,-100,1,0,2,20,400,0,0,0,1,1
1,BOX,5,-3,40,1,4,240,0,0,0,1,1
1,BOX,-5,-3,40,1,4,240,0,0,0,1,1
